28 16
#######
#.....#
#.@...######################
#..........................D
#.....#########.############
#.....#       #.#
#######       #.#
              #.#
              #.#
              #.#
          #####.##
          #......#
          #......#
          #......#
          #......#
          ########